8 7
1 1
2 2 2 2 2 2 2 2
2 0 0 0 0 0 0 2
2 0 0 0 0 0 0 2
2 0 0 0 0 0 0 2
2 0 0 0 0 0 0 2
2 0 0 0 0 0 0 2
2 2 2 2 102 2 2 2
