10 8,
1 4,
2 2 2 2 2 2 2 2 2 2
2 4 5 5 6 0 0 0 0 2
2 7 8 8 9 0 0 0 0 2
2 10 11 11 12 0 0 0 0 2
2 0 0 0 0 0 0 0 0 2
2 0 0 0 0 0 0 0 0 2
2 0 0 0 0 0 0 0 0 2
2 2 2 2 2 102 2 2 2 2,
0 1 0,

