19 19,
5 5,
2 2 2 2 2 2 2 2 2 103 2 2 2 2 2 2 2 2 2
2 0 0 0 0 2 0 0 0 0   0 0 0 2 0 0 0 0 2
2 0 0 0 0 2 0 0 0 0   0 0 0 2 0 0 0 0 2
2 0 0 0 0 2 0 0 0 0   0 0 0 2 0 0 0 0 2
2 0 0 0 0 2 0 0 0 0   0 0 0 2 0 0 0 0 2
2 0 0 2 2 2 0 0 0 0   0 0 0 2 2 2 0 0 2
2 0 0 0 0 0 0 0 0 0   0 0 0 0 0 0 0 0 2
2 0 0 0 0 0 0 0 0 2   0 0 0 0 0 0 0 0 2
2 0 0 0 0 0 0 0 0 2   0 0 0 0 0 0 0 0 2
2 0 0 0 0 0 0 2 2 2   2 2 0 0 0 0 0 0 2
2 0 0 0 0 0 0 0 0 2   0 0 0 0 0 0 0 0 2
2 0 0 0 0 0 0 0 0 2   0 0 0 0 0 0 0 0 2
2 0 0 0 0 0 0 0 0 0   0 0 0 0 0 0 0 0 2
2 0 0 2 2 2 0 0 0 0   0 0 0 2 2 2 0 0 2
2 0 0 0 0 2 0 0 0 0   0 0 0 2 0 0 0 0 2
2 0 0 0 0 2 0 0 0 0   0 0 0 2 0 0 0 0 2
2 0 0 0 0 2 0 0 0 0   0 0 0 2 0 0 0 0 2
2 0 0 0 0 2 0 0 0 0   0 0 0 2 0 0 0 0 2
2 2 2 2 2 2 2 2 2 2   2 2 2 2 2 2 2 2 2, ,
4 6 6

