18 7,
3 1,
2   13 2  2  13 2  2  13 2  2  13 2  2  13 2  2    13 2
2   0  0  0  0  0  0  0  0  0  0  0  0  0  0  0    0  2
2   0  4  5  5  5  5  5  5  5  5  5  5  5  5  6    0  2
101 0  7  8  8  8  8  8  8  8  8  8  8  8  8  9    0  2
2   0  10 11 11 11 11 11 11 11 11 11 11 11 11 12   0  2
2   0  0  0  0  0  0  0  0  0  0  0  0  0  0  0    0  2
2   2  2  2  2  2  2  2  2  2  2  2  2  2  2  103  2  2,
5 3  1
5 6  1
5 9  1
5 12 1
5 15 1
3 1  2
3 1  4,
0 16 1
1 16 5
0 11 3
1 6  5