18 7,
3 1,
2   13 2  2  13 2  2  13 2  2  13 2  2  13 2  2    13 2
2   0  0  0  0  0  0  0  0  0  0  0  0  0  0  0    0  2
2   0  4  5  5  5  5  5  5  5  5  5  5  5  5  6    0  2
101 0  7  8  8  8  8  8  8  8  8  8  8  8  8  9    0  2
2   0  10 11 11 11 11 11 11 11 11 11 11 11 11 12   0  2
2   0  0  0  0  0  0  0  0  0  0  0  0  0  0  0    0  2
2   2  2  2  2  2  2  2  2  2  2  2  2  2  2  103  2  2,
3 3 1
3 6 1
3 9 1
3 12 1
3 15 1,