8 7
4 5
2 2 2 2 2 2 2 2
2 0 0 0 0 0 0 2
2 0 0 0 0 0 0 2
2 0 0 0 0 0 0 102
2 0 0 0 0 0 0 2
2 0 0 0 0 0 0 2
2 2 2 2 2 2 2 2
