9 9,
6 3,
2   2 2  2 2 2 2  2 2
2   0 0  0 0   0 0  0 2
2   0 0  0 0   0 0  0 2
2   0 0  0 0   0 0  0 2
102 0 0  0 0   0 0  0 2
2   0 0  0 0   0 0  0 2
2   0 0  0 0   0 0  0 2
2   0 0  0 0   0 0  0 2
2   2 13 2 104 2 13 2 2, ,
3 1 7
3 7 7