9 9,
6 3,
2   2 2  2  2   2  2  2 2
2   0 0  0  0   0  0  0 2
2   0 4  5  5   5  6  0 2
2   0 7  8  8   8  9  0 2
102 0 7  8  8   8  9  0 2
2   0 7  8  8   8  9  0 2
2   0 10 11 11  11 12 0 2
2   0 0  0  0   0  0  0 2
2   2 13 2  104 2  13 2 2,
3 1 3
3 1 5
3 3 7
3 5 7,
3 1 7
3 7 7