8 7,
6 3,
2 2 2 2 2 2 2 2
2 0 0 0 0 0 0 2
2 0 0 0 0 0 0 2
2 0 0 0 0 0 0 102
2 0 0 0 0 0 0 2
2 0 0 0 0 0 0 2
2 2 2 2 2 2 2 2, ,
