20 20,
5 5,
2   2 2 2 2 2 2 2 2 2 2 2 2 2 2 2 2 2 2 2
100 0 0 0 0 0 0 0 0 0 0 0 0 0 0 0 0 0 0 2
2   0 0 0 0 0 0 0 0 0 0 0 0 0 0 0 0 0 0 2
2   2 2 2 0 0 2 0 0 2 0 0 2 2 2 2 2 0 0 2
2   0 0 0 0 0 2 0 0 2 0 0 2 0 0 0 2 0 0 2
2   0 0 0 0 0 2 0 0 2 0 0 2 0 0 0 2 0 0 2
2   2 2 2 2 2 2 0 0 2 0 0 2 0 0 0 2 0 0 2
2   0 0 0 0 0 0 0 0 2 2 2 2 0 0 0 2 0 0 2
2   0 0 0 0 0 0 0 0 2 0 0 0 0 0 0 0 0 0 2
2   2 2 2 2 2 2 0 0 2 0 0 0 0 0 0 0 0 0 2
2   0 0 0 0 0 0 0 0 0 0 0 2 0 0 2 2 2 2 2
2   0 0 0 0 0 0 0 0 0 0 0 2 0 0 0 0 0 0 2
2   2 2 2 2 2 2 0 0 2 0 0 2 0 0 0 0 0 0 2
2   0 0 0 0 0 2 0 0 2 0 0 2 2 2 2 2 2 2 2
2   0 0 0 0 0 0 0 0 2 0 0 0 0 0 0 0 0 0 2
2   0 0 0 0 0 0 0 0 2 0 0 0 0 0 0 0 0 0 2
2   2 2 2 2 2 2 0 0 2 2 2 2 2 2 2 2 2 2 2
2   0 0 0 0 0 0 0 0 0 0 0 0 0 0 0 0 0 0 2
100 0 0 0 0 0 0 0 0 0 0 0 0 0 0 0 0 0 0 2
2   2 2 2 2 2 2 2 2 2 2 2 2 2 2 2 2 2 2 2, ,
5 1 1