20 20,
5 5,
2 2 2 2 2 2 2 2 2 2 2 2 2 2 2 2 2 2 2 2
2 0 0 0 0 0 0 0 0 0 0 0 0 0 0 0 0 0 0 2
2 0 0 0 0 0 0 0 0 0 0 0 0 0 0 0 0 0 0 2
2 0 0 0 2 2 0 0 0 0 0 0 0 0 0 0 0 0 0 2
2 0 0 0 0 2 0 0 0 2 0 0 0 0 0 0 0 0 0 2
2 0 0 0 0 2 0 0 0 2 0 0 0 0 0 0 0 0 0 2
2 0 0 2 0 2 0 0 0 2 2 2 2 0 0 0 0 0 0 2
2 0 0 2 2 2 0 0 0 0 0 0 0 0 0 0 0 0 0 2
2 0 0 0 0 0 0 0 0 0 0 0 0 0 0 0 0 0 0 2
2 0 0 0 0 0 0 0 0 0 0 0 2 0 0 0 0 0 0 2
2 0 0 2 0 0 0 0 0 0 0 0 2 0 0 0 0 0 0 2
2 0 0 2 0 0 0 0 0 0 2 2 2 2 2 2 0 0 0 2
2 0 0 2 0 0 0 0 0 0 0 0 0 0 2 0 0 0 0 2
2 0 0 2 0 0 0 2 2 2 0 0 0 0 2 0 0 0 0 2
2 0 0 2 2 2 0 0 0 2 0 2 2 2 2 0 0 0 0 2
2 0 0 0 0 0 0 0 0 2 0 0 0 0 2 0 0 0 0 2
2 0 0 0 0 0 0 0 0 2 0 0 0 0 0 0 0 0 0 2
2 0 0 0 0 0 0 0 0 0 0 0 0 0 0 0 0 0 0 2
2 0 0 0 0 0 0 0 0 0 0 0 0 0 0 0 0 0 0 105
2 2 2 2 2 2 2 2 2 2 2 2 2 2 2 2 2 2 2 2, ,
